00000000000000000000000000000000000000000000000000000000000000000000000000000000000000000000000000000000000000000000000000000000
00000000000000000000000000000000000000000000000000000000000000000000000000000000000000000000000000000000000000000000000000000000
000000000000000000=>?0000000000000000000000000=?000000000000000000000000000000000000000012230000000000000=>>?0000000000000000000
00000000000000013000000=?0000000000000000=>>?000000000000000000000000000000000000000000185560000000000=?000000001300000=?0000000
23000=?000000122223000000001300000000=?000000000000012230000000300013000000000000000001855560000=>>?000000000000<@00130000000000
5:;300000=>?045555:;2300000<@00122300000000000000012855:;23000160004600012300000000001855556000000000000000000000000<@0000012222
55560000000004555555560000000004556000000000000000455555556000460004600045600012222278555556000000000000000000000000000000045555
555:AAAAAAAAA85555555:AAAAAAAAA855:AAAAAAAAAAAAAAA85555555:AAA8:AAA8:AAA85:AAA8555555555555:AAAAAAAAAAAAAAAAAAAAAAAAAAAAAAA85555